{
  "name": "Level 1 – Single Winding Path",
  "grid": [
    [0,0,0,0,0,0,1,1,1,1,1,1,1,1,1,1,1,1,1,1],
    [1,1,1,1,1,0,1,1,1,1,1,1,1,1,1,1,1,1,1,1],
    [1,1,1,1,1,0,1,1,1,1,1,1,1,1,1,1,1,1,1,1],
    [1,1,1,1,1,0,0,1,1,1,1,1,1,1,1,1,1,1,1,1],
    [1,1,1,1,1,0,0,0,0,0,1,1,1,1,1,1,1,1,1,1],
    [1,1,1,1,1,1,1,1,0,0,0,1,1,1,1,1,1,1,1,1],
    [1,1,1,1,1,1,1,1,0,0,0,0,0,1,1,1,1,1,1,1],
    [1,1,1,1,1,1,1,1,1,1,1,0,0,1,1,1,1,1,1,1],
    [1,1,1,1,1,1,1,1,1,1,1,1,0,0,1,1,1,1,1,1],
    [1,1,1,1,1,1,1,1,1,1,1,1,0,0,1,1,1,1,1,1],
    [1,1,1,1,1,1,1,1,1,1,1,1,1,0,0,0,1,1,1,1],
    [1,1,1,1,1,1,1,1,1,1,1,1,1,0,0,0,0,0,0,1],
    [1,1,1,1,1,1,1,1,1,1,1,1,1,1,1,1,1,1,0,1],
    [1,1,1,1,1,1,1,1,1,1,1,1,1,1,1,1,1,1,0,1],
    [1,1,1,1,1,1,1,1,1,1,1,1,1,1,1,1,1,1,1,1]
  ]
}
