{
  "name": "Level 2 – Complex Paths",
  "settings": {
    "initial_money": 150,
    "wave_count": 8,
    "enemy_speed": 60,
    "best_time": null
  },
  "grid": [
    [0,1,1,1,1,1,1,1,1,1,1,1,1,1,1,1,1,1,1,1],
    [0,0,1,1,1,1,1,1,1,1,1,1,1,1,1,1,1,1,1,1],
    [1,0,1,1,1,1,1,1,1,1,1,1,1,1,1,1,1,1,1,1],
    [1,0,0,0,1,1,1,1,1,1,1,1,1,1,1,1,1,1,1,1],
    [1,1,1,0,1,1,1,1,1,1,1,1,1,1,1,1,1,1,1,1],
    [1,1,1,0,0,0,0,1,1,1,1,1,1,1,1,1,1,1,1,1],
    [1,1,1,1,1,1,0,1,1,1,1,1,1,1,1,1,1,1,1,1],
    [1,1,1,1,1,1,0,0,0,0,1,1,1,1,1,1,1,1,1,1],
    [1,1,1,1,1,1,1,1,1,0,1,1,1,1,1,1,1,1,1,1],
    [1,1,1,1,1,1,1,1,1,0,0,0,0,0,1,1,1,1,1,1],
    [1,1,1,1,1,1,1,1,1,1,1,1,1,0,1,1,1,1,1,1],
    [1,1,1,1,1,1,1,1,1,1,1,1,1,0,0,0,0,1,1,1],
    [1,1,1,1,1,1,1,1,1,1,1,1,1,1,1,1,0,1,1,1],
    [1,1,1,1,1,1,1,1,1,1,1,1,1,1,1,1,0,0,0,1],
    [1,1,1,1,1,1,1,1,1,1,1,1,1,1,1,1,1,1,0,1]
  ]
}
